"a" = (/NPC/Grandpa,/turf/grass{icon_state = "base"},/area)
"b" = (/Enemies/Golem,/turf/grass{icon_state = "base"},/area)
"c" = (/turf,/area)
"d" = (/turf/grass{icon_state = "base"},/turf/flowers,/area)
"e" = (/turf/grass{icon_state = "base"},/turf/flowers{icon_state = "grass1"},/area)
"f" = (/turf/grass{icon_state = "base"},/turf/flowers{icon_state = "mushroom2"},/area)
"g" = (/turf/grass{icon_state = "base"},/turf/tree,/turf/flowers{icon_state = "grass1"},/area)
"h" = (/turf/grass{icon_state = "base"},/turf/flowers{icon_state = "mushroom1"},/area)
"i" = (/turf/grass{icon_state = "base"},/turf/rock,/area)
"j" = (/Item/HP_Potion,/turf/grass{icon_state = "base"},/area)
"k" = (/Enemies/Slime/SlimePoison,/turf/grass{icon_state = "base"},/area)
"l" = (/turf/grass{icon_state = "base"},/Enemies/Slime/SlimePoison,/turf/flowers,/area)
"J" = (/Enemies/Slime/Forest_Slime,/turf/grass{icon_state = "base"},/area)
"K" = (/Enemies/Slime/SlimeFire,/turf/grass{icon_state = "base"},/area)
"O" = (/turf/grass{icon_state = "base"},/area)
"S" = (/turf/grass{icon_state = "base"},/turf/tall_grass,/area)
"T" = (/turf/grass{icon_state = "base"},/turf/tree,/area)
"V" = (/turf/grass{icon_state = "base"},/turf/b,/area)

(1,1,1) = {"
OOOOOOOOOOOOOOOOOOOOOOOOOOOOOOOOOOOOOOOOOOOOOOOOOOOOOOOOOOOOOOOOOOOOOOOOOOOOOOOOOOOOOOOOOOOOOOOOOOcc
SSSSSSSSSSSSSSSSSSSSSSSSSSSSSSSSSSSSSSSSSSSSSSSSSSSSSSSSSSSSSSSSSSOOOOOOOOOOOOOOOOOOOOOOOOOOOOOOOOcc
SSSOOOOOOOOOOOOOOOSOOOOOOOOOOOOOOSOOOOOOOOOOOOdOOOeOOOOOOOffOSSSSSOOOOOOOOOOOOOOOOOOOOOOOOOOOOOOOOcc
SSSOOOOOJOOOOOOJOOSSOOOOOOOOKOOOKOOTOOdTOOdTOdOTOeegOOOTOOfTOSSSSSOOOOOOOOOOOOOOOOOOOOOOOOOOOOOOOOcc
SOOSSSSSOOOOOOOOOOSSOOOOOOOOOOOOOOOOOKOOOOKOOOOOOOKOOOKOOOOOOSSSSSOOOOOOOOOOOOOOOOOOOOOOOOOOOOOOOOcc
SOOOOOOOOOOJOOOOOOSSOOOOOOOOOOOOOOOOhOOOOOOOOOOOOOOOOOOOOOOOOSSSSSOOOOOOOOOOOOOOOOOOOOOOOOOOOOOOOOcc
SOOOOOOOOOOOOOOOOSSOOOJOOOOOOOOOOSTOOTOOTOOTOOTOOTOOTOOTOOOOOSSSSSOOOOOOOOOOOOOOOOOOOOOOOOOOOOOOOOcc
SOOOOOOOOOOOOOOOSSOOOOOOOOOOJOOOOSSSSSSSSSSSSSSSSSSSSSSSOOOkOSSSSSOOOOOOOOOOOOOOOOOOOOOOOOOOOOOOOOcc
SOOOOOOOOOOOOOOOOOOOOOOOOOOOOOOOOSSSSSSSSSSSSSSSSSSSSSSSOOOOOSSSSSOOOOOOOOOOOOOOOOOOOOOOOOOOOOOOOOcc
SOOOSSSSSSSSSSOOOOOOOOOOOOOOOOKOOSSSSSSSSSSSSSSSSSSSSSSSOlddOSSSSSOOOOOOOOOOOOOOOOOOOOOOOOOOOOOOOOcc
SOOOOOOOOOSSSSSOOOOOOOSOOOOOOOOOOSSSSSSSSSSSSSSSSSSSSSSSOdOdOSSSSSOOOOOOOOOOOOOOOOOOOOOOOOOOOOOOOOcc
SOOOOaOOOOOOOSSOOOOOOSSSSSSSOOOOSSSSSSSSSSSSSSSSSSSSSSSSOOdOOSSSSSOOOOOOOOOOOOOOOOOOOOOOOOOOOOOOOOcc
SOOOOjOOOOOOOOSTVOOjOOSSSSSSOOOOSSSSSSSSSSSSSSSSSSSSSSSSOddOOSSSSSOOOOOOOOOOOOOOOOOOOOOOOOOOOOOOOOcc
STVOOOJOOOOOOOSSSSOOOOOOSSSSOOOOSSSSSSSSSSSSSSSSSSSSSSSSOddlOSSSSSOOOOOOOOOOOOOOOOOOOOOOOOOOOOOOOOcc
SOOOOOOTVOOOJOOOOOOOOOOOOOOOOOOOSSSSSSSSSSSSSSSSSSSSSSSSOOOOOSSSSSOOOOOOOOOOOOOOOOOOOOOOOOOOOOOOOOcc
SOOOOOOOOOOOOOOOOOOOOOOOOOOOOOOSSSSSSSSSSdddddOOOOOOiiiiOOOOOSSSSSOOOOOOOOOOOOOOOOOOOOOOOOOOOOOOOOcc
SOOOOOOOOOOOOOOOOOOOOOOOOOOOOOOOOSSSSSSOdddOOOOOOOOOOiiiOOkOOSSSSSOOOOOOOOOOOOOOOOOOOOOOOOOOOOOOOOcc
SOOOOOOOOOOOOOOOOOOOOJOOOOOOOOOOOSSOSOOSddOOOOOOOOOOOOOOOOOOOSSSSSOOOOOOOOOOOOOOOOOOOOOOOOOOOOOOOOcc
SOOOOOOOOOOOOOOOOOOOOOOOOOOOOOOOOSSOOSTOdOOOOOOOOOOOOOOOOOOOOSSSSSOOOOOOOOOOOOOOOOOOOOOOOOOOOOOOOOcc
SOOOOOOOOOOOOOOOOOOOOOOOOOOOJOOOOSSSOOOSOOOOObOOOOOOOOOOOOjOOSSSSSOOOOOOOOOOOOOOOOOOOOOOOOOOOOOOOOcc
SOOOOOOOJOOOOTVOOOJOOOOOOOOOOOOOOSSOTSOOOOOOOOOOOOOOOiiiOOOOOSSSSSOOOOOOOOOOOOOOOOOOOOOOOOOOOOOOOOcc
SSSOOOOOOOOSSSSOOOOOOOOOOOOOOSOOOSSSSSTSOOOOOOOOOOOOOiiiiOOOOSSSSSOOOOOOOOOOOOOOOOOOOOOOOOOOOOOOOOcc
SOOSOOOOOOOOSSSOOOOOSSOOOOOOOSOSOSSSSOSOOOOOOOOTOOOOOOOiOOOOOSSSSSOOOOOOOOOOOOOOOOOOOOOOOOOOOOOOOOcc
SSOSOOOOTVOOSSOOOOOSSSSOOOOOOSSSSSSSSSSSSSSSSSSSSSSSSSSSSSSSSSSSSSOOOOOOOOOOOOOOOOOOOOOOOOOOOOOOOOcc
SSSSSSSSSSSSSSSSSSSSSSSSSSSSSSSSSSSSSSSSSSSSSSSSSSSSSSSSSSSSSSSSSSOOOOOOOOOOOOOOOOOOOOOOOOOOOOOOOOcc
"}
