"a" = (/NPC/Grandpa,/turf/grass{icon_state = "base"},/area)
"b" = (/Enemies/Golem,/turf/grass{icon_state = "base"},/area)
"c" = (/Item/Bow,/turf/grass{icon_state = "base"},/area)
"d" = (/Item/Teleport_Ab,/turf/grass{icon_state = "base"},/area)
"v" = (/Portal,/turf/grass{icon_state = "base"},/area)
"J" = (/Enemies/Slime/Forest_Slime,/turf/grass{icon_state = "base"},/area)
"K" = (/Enemies/Slime/SlimeFire,/turf/grass{icon_state = "base"},/area)
"O" = (/turf/grass{icon_state = "base"},/area)
"S" = (/turf/grass{icon_state = "base"},/turf/tall_grass,/area)
"T" = (/turf/grass{icon_state = "base"},/turf/tree,/area)
"V" = (/turf/grass{icon_state = "base"},/turf/b,/area)

(1,1,1) = {"
OOOOOOOOOOOOOOOOOOOOOOOOOOOOOOOOOOO
SSSSSSSSSSSSSSSSSSSSSSSSSSSSSSSSSSO
SSSOOOOOOOOOOOOOOOSOOOOOOOOOOOOOOSO
SSSOOOOOOOOOOOOOOOSSOOOOOOOOOOOOOSO
SOOSSSSSOOOOOOOOOOSSOOOOOOOOOOOOOSO
SOOOOOOOOOOOKOOOOOSSOOOOOOOOOOOOOSO
SOOOOOOOOOOOOOOOOSSOOOJOOOOOOOOOOSO
SOOOOOOOKOOOOOOOSSOOOOOOOOOOJOOOOSO
SOOOOOOOOOOOOOOOOOOOOOOOObOOOOOOOSO
SOOOSSSSSSSSSSOOOOOOOOOOOOOOOOOOOSO
SOOOOOOOOOSSSSSOOOOOOOSOOOOOOOOOOSO
SOOvOaOOOOOOOSSOOOOOOSSSSSSSOOOOSSO
SOOOOOOOOOOOOOSTVOOOOOSSSSSSOOOOSSO
STVOOcJOOOOKOOSSSSOOOOOOSSSSOOOOSSO
SOOdOOOTVOOOJOOOOOOOOOOOOOOOOOOOSSO
SOOOOOOOOOOOOOOOOOOOOOOOOOOOOOOSSSO
SOOOOOOOOOOOOOOOOOOOOOOOOOOOOOOOOSO
SOOOOOOOObOOOOOOOOOOOJOOOOOOOOOOOSO
SOOOOOOOOOKOOOOOOOOOOOOOOOOOOOOOOSO
SOOOOOOOOOOOOOOOOOOOOOOOOOOOOOOOOSO
SOOOOOOOJOOOOTVOOOOOOOOOOOOOOOOOOSO
SSSOOOOOOOOSSSSOOOOOOOOOOOKOOSOOOSO
SOOSOOOOOOOOSSSOOOOOSSOOOOOOOSOSOSO
SSOSOOOOTVOOSSOOOOOSSSSOOOOOOSSSSSO
SSSSSSSSSSSSSSSSSSSSSSSSSSSSSSSSSSO
"}
